1111111111111111111
1000000000000000001
1000000000000000001
10000000000000P0001
1000000000000000001
1000000000000000001
1000000E00000000001
100000000000C000001
1000000000000000001
1000000000000000001
1111111111111111111
