1111111111111111111111111
10000010000000000C00000E1
1110001000000000000000001
1000000000C0000000C0000P1
1000000100000000000000001
1000000100000001000000001
100C00010000C001000000001
1000000100000001000000001
1111111111111111111111111
