11111111111111111111111111111
10P00000000000010000000000001
10000000000000010000000000001
10000000000000010000000000001
10000000000000010000000000001
10000000000000010000000000001
10000000000000010000000000001
10000000000000010000000000001
11111111111111111111111111111
