




1111111111111111111111111
1000001000000000000000001
1000001000000000000000001
1000001000C0000000C000001
1000000000000000000000001
1000000000000001000000001
10000000000E0001000000001
1000P00000000001000000001
1111111111111111111111111
