11111111111111111111111111111
10000000000000010000000000001
1000000P000000010000000000001
1000000000C00001000000C000001
100000P0000000010000000000001
10000000000000010000000000001
100000E0000000010000000000001
10000000000000010000000000001
11111111111111111111111111111
