111111111111111111111111111111
1000000100000010100000000000E1
111110010111111010000000000001
1000000000C0000000C000000000P1
10100C111110000000000000000001
101111100010000100000000000001
101C00101010101000000000000001
101010101000101000000000000001
101010101111101100000000000001
101010101000000C10000000000001
101010101011111110000000000001
101010101000000010000000000001
101110101000000010000000000001
10000000100000C1C00C0000000001
111111111111111111111111111111
