1111111111111111111111111111111111111111111111111
10000001000000101000000000000000000000000000000E1
1111100101111110100000000000000000000000000000001
1000000000C0000000C0000000000000000000000000000P1
10100C1111100000000000000000000000000000000000001
1011111000100001000000000000000000000000000000001
101C001010101010000000000000000000000000000000001
1010101010001010000000000000000000000000000000001
1010101011111011000000000000000000000000000000001
101010101000000C100000000000000000000000000000001
1010101010111111100001111000000000000000000000001
1010101010000000100001001000000000000000000000001
1011101010000000100001111000000000000000000000001
10000000100000C1C00C00000000000000000000000000001
1111111111111111111111111111111111111111111111111
